##############################
######..g..#######........?..#
########w#########q##***###..#
###...........####.##*2*###..#
###..p.............##***###**#
###...........####.###########
##################.###########
#*#............###.###########
#*#..##1##*##..###.###########
#*?..##.##.##......###########
#*#............###############
##############################
