##########################
#p......#.......#######g##
#######.#.......#....##q##
#######.#...*......1.#*.*#
#.....#.#.......#....##.##
#..*....#.......#######.##
#.....#.###.######......##
#######............#######
##########################
