####################################################
#.......#.......#######.###.......#.......#######.##
#######.#.......#....##.#########.#.......#....##.##
#######.#............#............#...#........#...#
#.....#.#.......#....##.###.......#.......#....##.##
#.......#.......#######.###.......#.......#######.##
#.....#.###.######......###.....#.###.######......##
#######............##############............#######
#########.......###.............#.##########......##
#########.......#..........######.############..####
#.......#..###..#######.###.......#..#...#####..#..#
#######.#..###..#....##.#########.##.##.###.....#..#
#######.#..###.......#...########.#.............#..#
#.....#.#.......#....##.###.....#.#.......#....##..#
#.......#.......#######.###.......#.......#######..#
#.....#.###.######......###.....#.###...####.......#
#######............##############............#######
####################################################
