#############################
#...........................#
#.!.......................!.#
#...........................#
#...........................#
#............p..............#
#...........................#
#...........................#
#.!.......................!.#
#...........................#
#############################
