####################################################
#p.....*#.......#######.###.......#.......#######*##
#######.#..***..#....##.#########.#..***..#....##.##
#######.#..***.....*.#............#..*#*.....*.#*.*#
#..*..#.#.......#....##.###..***..#..***..#....##.##
#.***...#.......#######.###.......#.......#######.##
#..*..#.###.######......###.....#.###.######......##
#######............##############............#######
#########.......###.............#.##########......##
#########.......#..........######.############..####
#***....#..###..#######.###.......#..#...#####..#..#
#######.#..###..#....##.#########.##.##.###.....#..#
#######.#..###.....*.#...########.#..........*..#..#
#..*..#.#.......#....##.###.....#.#..***..#....##..#
#.***...#.......#######.###.......#.......#######..#
#..*..#.###.######......###.....#.###...####.......#
#######............##############............#######
####################################################
