############################
###*########################
###?######.............#####
#.....####r#########...#####
#..p..####e#####**.q...w.**#
#.....####w#########...#####
###.######q#####**.e...r.**#
#..........#########...#####
#..1.......q.2######...#####
#....##....#########.g.#####
#....##....#########...#####
#..........#################
#..........#################
##e######w##################
##.######.##################
##4######3##################
############################
