###########
#.?.?.?.?.#
#?#?#?#?#?#
#.?.?.?*?.#
#?#?#?#?#?#
#*?p?.?.?*#
#?#?#?#?#?#
#.?.?.?.?.#
#?#?#?#?#?#
#.?.?.?.?g#
###########
