###########################
#p......i#.......#######g##
#######.##.......#....##q##
#######.##...*......1.j#.*#
#.....#.##.......#....##.##
#..*....##.......#######.##
#.....#.####.######......l#
#######.............####?##
#######################***#
###########################
